C3:
|\          /|
| |\ ____ /| |
| | |    | | |
| | |____| | |
| |/      \| |
|/          \|

C2:
|\ ________ /|
| |        | |
| |        | |
| |        | |
| |________| |
|/          \|




; hack to clear the REPL screen
(print (str (char 27) "[2J"))